
fieldset-набор полей
submit-представлять на рассмотрение
required-необходимый, обязательный
search-поиск 
range-диапазон
scale - шкала
placeholder-заполнитель
autocomplete-автозаполнение
overlay - наложение
overflow - переполнение
shape - форма
hexagon - шестиугольник
skew - перекос
rect - прямой
shadow - тень
property - свойство

SVG (Scalable Vector Graphics) - маштабируемая векторная графика
PNG (portable network graphics) - портативная сетевая графика

back - назад
repeat - повторять
background - фон
initial - исходный
bottom - нижний
scroll - прокрутка
clip - обрезать
outline - контур

    border-image-source
source - источник
    border-image-slice
slice - кусочек
fill - заполнение

    text-decoration
line-through - линия, проходящая через.

    box-sizing
box-sizing: content-box; (по-умолчанию);
box-sizing: border-box; изменяет алгоритм расчёта ширины, задаёт общую ширину. 
